cd folder-name  -->  Change Directory:   It is used to change path/location/directory to other path/location/directory.
pwd  -->  Present working Directory: To check current path.
ls  -->  To list the files or folders in current path
ll  -->  To list the files and folders with RWX permissions.
mv --> To moves files from location/folder to other folders
rm  -->  To remove/delete files or folders
rm -rf  -->  To remove files or folders recursively
useradd  username  -->  To create a new user in linux
touch  -->  To create a text file.
mkdir -->  To create a new folder/directory
vi  -->  To edit the text file
cat  -->  To view the contents of text file
sudo  -->  Admin priviliges
sudo su  -->  To login as root user
sudo su username  -->  To login as specific user
whoami  -->  To check current user
cat /etc/passwd  -->  To view the total number users created in our system
cd  -->  To enter default user folder
cd /  -->  To enter root directory
cd ..  -->  go to previous directory
echo  -->  to print the contents of file
username passwd  -->  To change the password for the user
nohup  -->  To run the applications in the background
ifconfig  -->  To display the system/server ip address
chmod  -->  To change mode of directory
usrmod   -->  To command to add a user to a group, change a user shell, login name, home directory, and more.
grep  -->  To concatenate the text or two different commands
kill  -->  To stop current running processes
find  -->  used to search any file 
wget/curl   -->  To download files from internet
yum  -->  To download and install software packages and dependencies from RPM repository
ls -a   -->  To list all files (including hidden files) and folders in current directory
cp -i from_path  to_path    -->  Copy files from one location to other location
clear  -->  To clear the screen(Shorcut-CTRL + L)
rpm -qa  -->  To display the installed packages
rpm -qi   -->  To display installed packages along with package version and description
rpm -e  -->  Erase packages
